7 20
||||||||||||||||||S|
|               || |
| ||||| ||||    || |
| |  |   |  ||  || |
| |         ||| || |
| | || ||   ||     |
||||||X|||||||||||||
